NO ./assets/no.xpm
SO ./assets/so.xpm
WE ./assets/we.xpm
EA ./assets/ea.xpm

F 255,0,0
C 0,0,0

11011
10001
10S01
10001
11111
