NO ./assets/no.xpm
SO ./assets/so.xpm
WE ./assets/we.xpm
EA ./assets/ea.xpm

F 0,122,122
C 0,0,0

1111111111
1000000011
1000011001
10N0000001
1000001011
1000011001
1010000001
1000011001
1010100001
1111111111
