NO ./assets/no.xpm
SO ./assets/so.xpm
WE ./assets/we.xpm
EA ./assets/ea.xpm

F 0,122,122
C 0,0,0

1111111111
1000000011  111111111  111111
1000011001  100000001  100001
10S00000011110100000111100001
10000010100000100000000000001
10000110000000100000000000001
10100000000000000000011100001
1000011001111111111111 100001
1010100001             100001
1111111111             111111
